EA          ./img/barrel.xpm
NO          ./img/bluestone.xpm
SO            ./img/redbrick.xpm



WE    ./img/wood.xpm

                F 255,100,150
          C 0,25,50


                           



        111111111111111111111111
        1000000000110000000000001
        1011000001110000000000001
        1001000000000000000000001
111111111011000001110000000000001
100000000011000001110111111111111
11110111111111011100000010001
11110111111111011101010010001
11000000110101011100000010001
1000000000000000110000010001
10000000000000001101010010001
110000011101010111110111100111
11110111 1110101 1011110N001
111111111 111111 11111111111
      1 1
      111
1
1            111
             11
            1111