



EA          ./parsing/map2.xpm
NO          ./parsing/map2.xpm
SO             ./parsing/map2.xpm



WE ./parsing/map2.xpm



                           



                F 242,100,0





C 225,30,0


        1111111111111111111111111
        1000000000110000000000001
        1011000001110000000000001
        1001000000000000000000001
111111111011000001110000000000001
100000001111000001110111111111111
1111011110111101110000001000111101
11110111101111011101010010001
11000000110101011100000010001
10000000000000001100000010001
10000000000000001101010010001
11000001110101011111011110N0111
11110111 1110101 101111010001
11111111 1111111 111111111111