



EA          ./parsing/map2.xpm
NO          ./parsing/map2.xpm
SO             ./parsing/map2.xpm



WE ./parsing/map2.xpm



                           



                F 242,100,0





C 225,30,0


111
1111
1N11
1111
1111