C 18,255,170
EA ./img/barrel.xpm
NO ./img/bluestone.xpm
SO ./img/redbrick.xpm
F 18,255,170
WE ./img/wood.xpm

1111111
100E001
1111111